Map: 10,42{
1,1,1,1,1,1,1,1,1,1
1,2,2,2,2,2,3,2,2,1
1,1,1,2,1,1,1,1,2,1
1,6,1,2,1,2,2,2,2,1
1,2,7,1,2,4,3,1,1,1
1,2,2,1,2,1,2,1,1,1
1,2,2,1,2,1,1,2,2,1
1,2,1,2,2,2,1,2,2,1
1,2,2,1,2,1,2,2,6,1
1,1,2,10,2,10,2,1,1,1
1,1,1,1,2,1,1,1,1,1
1,2,2,1,2,1,2,2,2,1
1,2,2,2,2,2,2,2,9,1
1,2,2,2,2,2,2,2,9,1
1,2,2,2,2,2,2,2,9,1
1,9,2,2,2,2,2,2,9,1
1,9,2,2,2,2,2,2,9,1
1,9,2,2,2,2,2,2,9,1
1,2,9,9,9,9,9,9,2,1
1,4,1,1,1,1,1,1,1,1
1,10,1,10,2,10,2,2,2,1
1,10,10,2,2,1,1,2,2,1
1,1,1,1,2,2,1,2,2,1
1,1,1,1,1,1,1,2,2,1
1,2,9,9,9,9,9,2,2,1
1,2,1,1,1,1,1,2,2,1
1,2,1,2,2,2,1,2,2,1
1,2,1,2,2,2,1,2,2,1
1,2,1,2,2,2,1,1,1,1
1,2,2,2,2,2,2,2,2,1
1,1,1,2,2,2,2,1,2,1
1,1,1,2,2,2,2,1,2,1
1,1,1,2,2,2,2,1,2,1
1,1,1,1,1,1,1,1,2,1
1,2,2,2,2,2,2,2,2,1
1,2,2,2,2,2,2,2,2,1
1,2,2,2,2,2,2,2,2,1
1,2,2,2,2,2,2,2,2,1
1,2,2,2,2,2,2,2,2,1
1,2,2,2,2,2,2,2,2,1
1,5,2,2,2,2,2,2,2,1
1,1,1,1,1,1,1,1,1,1
}

Fireboot: 3, 3
Flippers: 6, 5
Doorkey: 8, 6, green
Coldoor: 4, 10, green
StraightLineEnemy: 3, 7, east
Teleporter: 1, 3, 8, 8
Flippers: 1, 11
Iceskate: 6, 11
DumbTargetingEnemy: 2, 17
Coldoor: 6, 20, blue
Doorkey: 5, 22, blue
StraightLineEnemy: 7, 24, east
StraightLineEnemy: 3, 26, south
StraightLineEnemy: 4, 30, north
StraightLineEnemy: 5, 26, south
SmartTargetingEnemy: 1, 34
SmartTargetingEnemy: 8, 40
Goal:
Spawn: 1, 1
