Map: 9, 11 {
1,1,1,1,1,1,1,1,1
1,2,2,10,2,2,2,2,1
1,2,2,2,2,2,2,2,1
1,2,2,2,2,2,2,2,1
1,2,2,2,2,2,2,2,1
1,2,2,2,2,2,2,2,1
1,2,2,2,2,2,2,2,1
1,6,2,2,2,2,2,6,1
1,2,2,2,2,2,2,2,1
1,2,2,2,2,2,2,2,1
1,1,1,1,1,1,1,1,1

}

Wallfollowingenemy: 1,5, south, west
TokenDoor: 5,8,1
Teleporter: 7, 2, 7, 4
Teleporter: 7, 4, 7, 2
Spawn: 2, 5
Goal: 04TestLevel2.txt

Spawn:1,1
Goal: 05TestLevel2.txt


