Map: 7, 7 {
1,1,1,1,1,1,1
1,9,9,9,9,9,1
1,9,2,2,2,9,1
1,9,2,2,2,9,1
1,9,2,2,2,9,1
1,9,9,9,9,9,1
1,1,1,1,1,1,1
}
Iceskate: 3,2
Spawn: 3,3