Map: 10, 8{
1,1,1,1,1,1,1,1,1,1
1,2,2,2,2,2,2,2,2,1
1,2,2,2,2,2,2,2,2,1
1,2,2,9,9,9,2,2,2,1
1,2,2,2,2,2,2,2,2,1
1,2,2,2,2,2,2,2,2,1
1,2,2,2,2,2,2,2,2,1
1,1,1,1,1,1,1,1,1,1

}

Spawn:3,2
Goal:
Iceskate: 3, 1