Map: 7, 7 {
1,1,1,1,1,1,1
1,7,2,2,2,2,1
1,2,2,2,2,2,1
1,2,2,2,2,2,1
1,2,2,2,2,2,1
1,2,2,2,2,2,1
1,1,1,1,1,1,1
}
Spawn: 3,3
TokenDoor: 1,1,3
Token: 2,1,1
Token: 3,1,1
Token: 4,1,1
Token: 5,1,1