MAP: 10, 42 {
1,1,1,1,1,1,1,1,1,1
1,2,2,2,2,2,2,2,2,1
1,1,1,1,1,1,1,2,2,1
1,2,2,2,2,3,2,2,2,1
1,2,2,2,2,3,2,2,2,1
1,4,4,1,1,1,1,2,2,1
1,4,4,4,4,4,1,2,2,1
1,4,4,4,4,4,1,1,1,1
1,4,4,4,4,4,1
1,4,4,4,4,4,1,1,1,1
1,4,4,4,4,4,2,2,6,1
1,1,1,1,1,1,1,1,1,1
1,2,2,2,1,2,2,1,6,1
1,1,1,1,1,2,2,1,2,1
1,6,2,2,1,1,1,1,2,1
1,1,1,2,2,2,2,2,2,1
1,1,1,1,1,1,1,1,1,1
1,2,2,1,9,1,9,9,9,1
1,2,2,1,9,9,9,9,9,1
1,6,2,2,9,9,9,9,9,1
1,1,1,1,1,1,9,1,1,1
1,9,1
1,9,1
1,1,1,1,1,1,9,9,9,1
1,2,2,2,2,2,1,2,2,1
1,2,2,2,2,2,2,2,2,1
1,8,1,8,1,8,1,8,1,1
1,2,1,2,1,2,1,2,1
1,10,1,1,1,1,1,1,1,1
1,2,2,2,2,2,2,2,2,1
1,1,1,1,1,8,1,1,7,1
1,2,1,1,2,1
1,1,1,1,1,1,1,1,2,1
1,2,2,9,9,9,9,9,2,1
1,6,1,1,1,1,1,1,1,1
1,1,1
1,1,1,1,1,1,1,1,1,1
1,2,2,2,2,2,2,6,2,1
1,2,2,2,2,2,2,2,2,1
1,2,2,2,2,2,2,2,2,1
1,2,2,2,5,2,2,2,2,1
1,1,1,1,1,1,1,1,1,1
}
Spawn: 5,1
Goal: 
Teleporter: 8,10, 1,14
Teleporter: 8,12, 1,19
Teleporter: 1,14, 8,10
Teleporter: 1,19, 8,12
ColDoor: 1,26,red
ColDoor: 3,26,blue
ColDoor: 5,26,green
ColDoor: 7,26,yellow
ColDoor: 5,30,red
TokenDoor: 8,30,2
Teleporter: 1,34, 7,37
Teleporter: 7,37, 1,34
Flippers: 1,4
FireBoot: 8,6
DoorKey: 1,25,red
DoorKey: 2,25,blue
DoorKey: 3,25,green
DoorKey: 4,25,yellow
Token: 4,29,1
DoorKey: 8,29,red
Token: 5,31,1
dumbtargetingenemy: 1,37
wallfollowingenemy: 6,12
straightlineenemy: 2,12
inv: help
