#Creeper
Map: 16, 16 {
1,1,1,1,1,1,1,1,1,1,1,1,1,1,1,1
1,2,2,2,2,2,2,2,2,2,2,2,2,2,2,1
1,2,3,3,3,3,2,2,2,2,3,3,3,3,2,1
1,2,3,3,3,3,2,2,2,2,3,3,3,3,2,1
1,2,3,3,3,3,2,2,2,2,3,3,3,3,2,1
1,2,3,3,3,3,2,2,2,2,3,3,3,3,2,1
1,2,2,2,2,2,3,3,3,3,2,2,2,2,2,1
1,2,2,2,2,2,3,3,3,3,2,2,2,2,2,1
1,2,2,2,3,3,3,3,3,3,3,3,2,2,2,1
1,2,2,2,3,3,3,3,3,3,3,3,2,2,2,1
1,2,2,2,3,3,3,3,3,3,3,3,2,2,2,1
1,2,2,2,3,3,3,3,3,3,3,3,2,2,2,1
1,2,2,2,3,3,2,5,2,2,3,3,2,2,2,1
1,2,2,2,3,3,7,4,4,4,3,3,2,2,2,1
1,2,2,2,2,2,2,2,2,2,2,2,2,2,2,1
1,1,1,1,1,1,1,1,1,1,1,1,1,1,1,1
}
TokenDoor: 6,13,6
Spawn: 8, 3
Goal:22ObligitoryIceLevel.txt
Token: 1, 1, 1
Token: 14, 1, 1
Token: 5, 6, 1
Token: 12, 9, 1
Token: 5, 14, 1
Token: 10, 14, 1
WallfollowingEnemy: 4, 7, east,south
WallfollowingEnemy: 11, 6, south,west
WallfollowingEnemy: 7, 5, north,east
