Map:14,17{
1,1,1,1,1,1,1,1,1,1,1,1,1,1
1,1,1,9,9,1,9,9,9,9,9,1,1,1
1,1,1,9,9,9,9,9,9,9,9,8,6,1
1,1,1,9,9,9,9,9,9,1,9,1,1,1
1,2,2,9,1,9,9,1,9,9,2,2,1,1
1,1,1,1,1,1,1,1,1,1,1,1,1,1
1,1,1,1,1,1,1,1,1,1,1,1,1,1
1,2,2,2,2,1,1,6,2,2,2,2,1,1
1,2,2,5,2,1,1,1,1,1,2,1,1,1
1,2,2,2,2,1,1,1,9,9,9,1,9,1
1,2,2,2,2,1,1,9,9,9,9,9,9,1
1,2,2,2,2,8,9,9,9,9,9,9,1,1
1,1,1,1,1,1,1,9,1,9,9,9,9,1
1,1,1,1,1,1,9,9,9,9,9,9,9,1
1,1,1,2,2,2,9,9,9,1,9,9,9,1
1,2,2,2,1,1,1,1,1,1,1,1,1,1
1,1,1,1,1,1,1,1,1,1,1,1,1,1
}
Spawn: 1,4
Goal:23FourKeys.txt

Iceskate: 2,4

Doorkey: 11, 4, red
Doorkey: 1, 15, green

Coldoor: 11,2, red
Coldoor: 5,11, green

Teleporter:12,2,7,7
Teleporter:7,7,12,2