Map: 16, 16 {
1,1,1,1,1,1,1,1,1,1,1,1,1,1,1,1
1,2,2,2,2,2,2,2,2,2,2,1,2,2,2,1
1,2,1,1,1,1,1,1,1,2,2,1,2,1,1,1
1,2,1,2,2,2,8,2,1,2,2,1,2,2,2,1
1,2,1,2,1,2,1,2,1,2,2,1,1,1,8,1
1,2,1,2,1,2,1,2,1,2,2,8,2,2,2,1
1,2,1,1,1,2,1,2,1,1,1,1,2,2,2,1
1,2,1,2,2,2,1,5,1,2,2,2,2,2,2,1
1,2,1,2,2,2,1,1,1,2,2,2,2,2,2,1
1,2,1,2,2,2,2,2,1,2,2,2,2,2,2,1
1,2,1,2,2,2,2,2,1,2,2,1,2,2,2,1
1,2,1,2,1,1,1,1,1,1,8,1,1,1,1,1
1,2,1,2,2,2,2,2,2,2,2,2,2,2,2,1
1,1,1,1,1,1,1,1,1,1,1,1,1,2,2,1
1,2,2,2,2,2,2,2,2,2,2,2,2,2,2,1
1,1,1,1,1,1,1,1,1,1,1,1,1,1,1,1
}
Spawn: 1, 14

Doorkey: 3, 5, green
Doorkey: 14, 1, red
Doorkey: 12, 10, blue
Doorkey: 1, 12, yellow

Coldoor: 6, 3, yellow
Coldoor: 10, 11, green
Coldoor: 14, 4, blue
Coldoor: 11, 5, red

Straightlineenemy:5,10,north
Straightlineenemy:11,8,north
Straightlineenemy:14,10,west

Goal:24DanceTilYou'reDead.txt