Map: 20, 15 {
1,1,1,1,1,1,1,1,1,1,1,1,1,1,1,1,1,1,1,1
1,9,9,9,9,9,9,9,9,1,9,9,9,9,9,1,1,2,5,1
1,9,9,9,1,9,9,9,9,9,9,9,9,9,9,1,1,2,2,1
1,2,9,9,9,9,9,9,9,9,1,9,9,9,9,1,2,2,2,1
1,2,1,9,9,9,9,9,9,9,9,9,9,9,9,1,2,2,2,1
1,1,9,9,9,9,9,9,9,1,9,9,9,9,9,1,2,2,2,1
1,9,9,9,9,9,9,9,9,9,9,9,9,9,1,1,1,1,8,1
1,9,9,9,9,9,9,1,9,9,9,9,9,9,2,2,2,2,2,1
1,9,9,1,9,9,9,9,9,9,9,9,9,9,2,2,2,2,2,1
1,9,9,9,9,9,9,9,9,9,9,9,9,9,1,1,1,1,1,1
1,9,9,9,9,9,9,9,1,9,9,9,9,9,9,1,1,1,1,1
1,9,9,9,9,9,1,9,9,9,1,9,9,9,9,1,1,1,1,1
1,9,9,9,9,9,9,9,9,9,9,9,9,9,9,1,1,2,2,1
1,1,1,1,1,1,1,1,1,1,1,1,1,1,2,2,2,2,2,1
1,1,1,1,1,1,1,1,1,1,1,1,1,1,1,1,1,1,1,1
}
Iceskate: 15,13
Spawn: 18,12
Coldoor:18,6,red
Doorkey:1,4,red
Goal:26Spherical.txt