#Enemy sprites are misaligned, needs fixing
Map: 31,31{
0,0,0,0,0,0,0,0,0,0,0,1,1,1,1,1,1,1,1,1,0,0,0,0,0,0,0,0,0,0,0
0,0,0,0,0,0,0,0,0,1,1,1,1,6,1,6,1,6,1,1,1,1,0,0,0,0,0,0,0,0,0
0,0,0,0,0,0,0,1,1,2,2,1,2,2,2,2,2,2,2,1,2,2,1,1,0,0,0,0,0,0,0
0,0,0,0,0,1,1,2,2,2,2,1,2,2,2,2,2,2,2,1,2,2,2,2,1,1,0,0,0,0,0
0,0,0,0,1,1,2,2,2,2,2,1,2,2,2,2,2,2,2,1,2,2,2,2,2,1,1,0,0,0,0
0,0,0,1,1,2,2,2,2,2,2,1,1,1,1,4,1,1,1,1,2,2,2,2,2,2,1,1,0,0,0
0,0,0,1,2,2,2,2,2,2,2,1,2,2,2,2,2,2,2,1,2,2,2,2,2,2,2,1,0,0,0
0,0,1,2,2,2,2,2,2,2,2,1,2,2,2,5,2,2,2,1,2,2,2,2,2,2,2,2,1,0,0
0,0,1,2,2,2,2,2,2,2,2,1,2,2,2,2,2,2,2,1,2,2,2,2,2,2,2,2,1,0,0
0,1,2,2,2,2,2,2,2,7,1,1,1,1,1,1,1,1,1,1,2,2,2,2,2,2,2,2,2,1,0
0,1,1,1,1,1,1,1,1,2,2,2,2,2,2,2,2,2,2,2,2,2,2,2,2,2,2,2,2,1,0
1,2,2,2,2,2,2,2,1,2,2,2,2,2,2,2,2,2,2,2,2,2,2,2,2,2,2,2,2,2,1
1,2,2,2,2,2,2,2,1,2,2,2,2,2,2,2,2,2,2,2,2,2,2,2,2,2,2,2,2,2,1
1,2,1,1,1,2,2,2,1,2,2,2,2,2,2,2,2,2,2,2,1,1,1,1,1,1,1,1,1,1,1
1,2,2,2,1,2,2,2,1,2,2,2,2,2,2,2,2,2,2,2,1,1,2,2,1,9,1,9,9,1,1
1,6,1,2,1,2,2,2,1,1,1,1,1,1,1,1,1,1,1,2,8,9,9,9,9,9,9,9,9,1,1
1,1,8,2,1,2,2,2,4,2,2,2,2,2,1,2,2,2,1,2,1,9,9,9,9,9,9,9,9,1,1
1,2,2,1,1,3,1,1,1,2,1,1,1,2,1,2,2,2,4,2,1,9,9,9,1,9,9,1,9,2,1
1,2,2,1,2,2,2,2,1,2,1,2,1,2,1,2,2,2,1,2,1,1,1,1,1,1,1,1,1,6,1
1,2,2,1,2,2,2,2,1,2,1,2,1,2,2,2,2,2,1,2,2,2,2,2,1,2,2,2,2,1,1
0,1,2,1,2,2,2,2,1,2,1,2,1,1,1,1,1,2,1,2,2,2,2,2,1,2,2,2,2,1,0
0,1,2,1,2,2,2,2,1,2,2,2,1,2,2,2,2,2,1,2,2,2,2,2,1,2,2,2,2,1,0
0,0,1,1,1,1,1,1,1,1,1,1,1,8,1,1,1,1,1,1,1,1,1,1,1,2,2,2,1,0,0
0,0,1,1,2,2,2,2,2,2,2,2,2,2,2,2,2,2,2,2,2,2,2,2,1,2,2,2,1,0,0
0,0,0,1,2,2,2,2,2,2,2,2,2,2,2,2,2,2,2,2,2,2,2,2,1,2,2,1,0,0,0
0,0,0,1,1,1,1,1,1,1,1,1,1,1,1,1,1,1,2,2,2,2,2,2,4,2,1,1,0,0,0
0,0,0,0,1,1,2,2,2,2,2,2,2,2,2,2,2,1,2,2,2,1,1,2,1,1,1,0,0,0,0
0,0,0,0,0,1,1,2,2,2,2,2,2,2,2,1,6,1,1,1,1,2,2,2,1,1,0,0,0,0,0
0,0,0,0,0,0,0,1,1,2,2,2,2,2,2,2,1,2,2,2,2,2,1,1,0,0,0,0,0,0,0
0,0,0,0,0,0,0,0,0,1,1,2,2,2,2,2,2,2,2,2,1,1,0,0,0,0,0,0,0,0,0
0,0,0,0,0,0,0,0,0,0,0,1,1,1,1,1,1,1,1,1,0,0,0,0,0,0,0,0,0,0,0
}
Spawn: 15,3
Goal: 27Pipman.txt

Doorkey:11,18,red
Doorkey:22,14,green
Doorkey:2,21,yellow

ColDoor:20,15,red
ColDoor:2,16,green
ColDoor:13,22,yellow

Fireboot:13,29
Flippers:22,20
Iceskate:5,20

Teleporter:13,1,1,15
Teleporter:1,15,13,1

Teleporter:15,1,16,27
Teleporter:27,16,1,15

Teleporter:17,1,29,18
Teleporter:29,18,17,1

TokenDoor:9,9,7

#Straightlineenemy: 7,7,east
#Straightlineenemy: 10,27,east
#Straightlineenemy: 14,28,west

#Wallfollowingenemy: 6,18,south,west
#Wallfollowingenemy: 5,21,north,east

Token:27,22,1
Token:25,5,1
Token:17,16,1
Token:6,26,1
Token:4,24,1
#Token:2,21,1
Token:4,19,1
Token:7,20,1

Help: 5,5,Congrats!,You,found,an,easter,egg!,1/50,unlocked.